uHTTP	KEYWORD1
uHTTP_request	KEYWORD1
uHTTPclient	KEYWORD1
uHTTPclient	KEYWORD2	
requestHandler	KEYWORD1	
head	KEYWORD2
method	KEYWORD2
uri	KEYWORD2
query	KEYWORD2
body	KEYWORD2
data	KEYWORD2
webFile_Post	KEYWORD2
webFile_Post_Head	KEYWORD2
render	KEYWORD2
send_headers	KEYWORD2
send_body	KEYWORD2
send_method_headers	KEYWORD2
get_request	KEYWORD2
put_request	KEYWORD2
post_JSON	KEYWORD2
send_JSON_headers	KEYWORD2
addToContainer	KEYWORD2
uHTTP_METHOD_GET	KEYWORD2
uHTTP_METHOD_HEAD	KEYWORD2
uHTTP_METHOD_POST	KEYWORD2
uHTTP_METHOD_PUT	KEYWORD2
uHTTP_METHOD_PATCH	KEYWORD2
uHTTP_METHOD_DELETE	KEYWORD2
uHTTP_METHOD_TRACE	KEYWORD2
uHTTP_METHOD_CONNECT	KEYWORD2

